01001020011010010100020100101000101001020100010010102010100101010010200010200101-
01000100101020101001010100102000102001011001010200020010101002010010100010100102-
10010102000200101010020100101000101001021001010200020010101002010010100010100102-
01001020011010010100020100101000101001020100010010102010100101010010200010200101-
01000100101020101001010100102000102001011001010200020010101002010010100010100102-
10010102000200101010020100101000101001021001010200020010101002010010100010100102-
01001020011010010100020100101000101001020100010010102010100101010010200010200101-
01000100101020101001010100102000102001011001010200020010101002010010100010100102-
10010102000200101010020100101000101001021001010200020010101002010010100010100102-
01001020011010010100020100101000101001020100010010102010100101010010200010200101-
01000100101020101001010100102000102001011001010200020010101002010010100010100102-
10010102000200101010020100101000101001021001010200020010101002010010100010100102-
01001020011010010100020100101000101001020100010010102010100101010010200010200101-
01000100101020101001010100102000102001011001010200020010101002010010100010100102-
01001020011010010100020100101000101001020100010010102010100101010010200010200101-
01000100101020101001010100102000102001011001010200020010101002010010100010100102-
10010102000200101010020100101000101001021001010200020010101002010010100010100102-
01001020011010010100020100101000101001020100010010102010100101010010200010200101-
01000100101020101001010100102000102001011001010200020010101002010010100010100102-
10010102000200101010020100101000101001021001010200020010101002010010100010100102-
01001020011010010100020100101000101001020100010010102010100101010010200010200101-
01000100101020101001010100102000102001011001010200020010101002010010100010100102-
10010102000200101010020100101000101001021001010200020010101002010010100010100102-
01001020011010010100020100101000101001020100010010102010100101010010200010200101-
01000100101020101001010100102000102001011001010200020010101002010010100010100102-
10010102000200101010020100101000101001021001010200020010101002010010100010100102-
01001020011010010100020100101000101001020100010010102010100101010010200010200101-
01000100101020101001010100102000102001011001010200020010101002010010100010100102-
01001020011010010100020100101000101001020100010010102010100101010010200010200101-
01000100101020101001010100102000102001011001010200020010101002010010100010100102-
10010102000200101010020100101000101001021001010200020010101002010010100010100102-
01001020011010010100020100101000101001020100010010102010100101010010200010200101-
01000100101020101001010100102000102001011001010200020010101002010010100010100102-
10010102000200101010020100101000101001021001010200020010101002010010100010100102-
01001020011010010100020100101000101001020100010010102010100101010010200010200101-
01000100101020101001010100102000102001011001010200020010101002010010100010100102-
10010102000200101010020100101000101001021001010200020010101002010010100010100102-
01001020011010010100020100101000101001020100010010102010100101010010200010200101-
01000100101020101001010100102000102001011001010200020010101002010010100010100102-
10010102000200101010020100101000101001021001010200020010101002010010100010100102-
01001020011010010100020100101000101001020100010010102010100101010010200010200101-
01000100101020101001010100102000102001011001010200020010101002010010100010100102-
10010102000200101010020100101000101001021001010200020010101002010010100010100102