00034567788900000000000000000000000020000000000000000000100000000000000000000000000-
00000000780000000000000000000000000000000000000000400000000000010000000000000000000-
00000000780000000000000000000000000000000000000000000000000000000002000000040000000-
00400000780000000000000001200000000000000002000000000000000000000000000000000000000-
00000000780000000000000000000000000000000000000002635066000000000100000000000000000-
00004000780000000000120000000000002000000100000006531638000000000000000000000000000-
00000000780000000000000000000000000000000000000009936360000000000400000000000000000-
00000000780000000000000000000000000010000000000003333366000000000000000000000000000-
04000000780000040000000000000040000000000000000006663663000000000004000000000000000-
00000000780000000000000000000000000000000000000589900000000000000000000000200000000-
00000000780000000000000400000000000000000000003600000000000000000000000000000000000-
00000000780000000000000000000000000000000000589000000000000000000000010000000000000-
00000000780000000000000000000000000000000005600000000012000000000000000000000000000-
00000000785555555555555555555555555555555500555555555555555055550505550550000000000-
00000000736363636363636363636363636363636363636363666336363366633636326300000000000-
00000000036639366366633363636363363363636633363633636363663636399646436800000000000-
00000000999999999900999999999099999999339999999999909999909090999999909000000000000-
00400000000000000000000000000000000000768000000000000000002100000000036000004000000-
00000000000000000000002000000000000000768000000000000000000000000000036000002000000-
00000040000000000000000000040000000000738000000000000000000000000000036000000010000-
00000000000000000000000000000000000000768000000000224400000000000000036000010000000-
00000004002000000000000000001100000000738000000000122100000000000000036000000000000-
00000000000000100000000000000000000000768000000000000000000000000000063000000000000-
00000000000000000000000000000000000000748000000000000000000000000000063000000000000-
00000000000000000000000000000000000000768000000010000000000000000000063000000000000-
00000000000000000200400000000000000000768000000000000000000000000000063000442100000-
00000000000000000002000000000000000000738000020000000000000000000000066000001400000-
00000000000000000000001000000000000000798000100000005663363616300000033000400200000-
00000000000000000000000400063636363636738000000000006363636362300000036000000000000-
00000000200000000555555555699909999999768000000000006363063636300000063000000000000-
00000000200000007363636363680000000000738000000000003603636363600000066000004000000-
00000040000000007636363636380000000000798000000000006336363636700000036000000000000-
00000100000000007666333366680000000000738000000000009968900000000000066000000000000-
00000000000000007363036363680000000000768000200000000078000000000000066000000100000-
00000000000000007363636363680000000000768000000000000073636055555555536000000000000-
00000010000000000999999999980000000000738000000000663363636363666633363000000000000-
00000000000000000000000000000000000000000002000000919929999999929999936000000000000-
00000020000000000010002000000000000000000000000000000000000000000000036000000000000-
00000000000000000000000001000000000100040000000000000000000000000000063000000000000-
00000000400000000020000000000000200000000000000000000000000000000000063000000000000-
00000000000000000000000000040000000000000000000000000000000000000000033000000000000-
00000000000000000000000000000000000000000000000000000000000000000000066000000000000-
00000000000000000000000000000000000000000000000000000000000000000000066000000000000-
00000000000000000000000000000000000000000000000000000000000000000000066000000000000